25
02 c 0 | 02 d 0 | 02 c 0 | 03 d 0 | 02 c 0 | 02 c 0 | 03 d 0 | 02 c 0 | 03 d 0 | 02 c 0 | 02 c 0 | 03 d 0 | 02 c 0 | 03 d 0 | 02 c 0 | 03 d 0 | 02 c 0 | 05 c 0 | 02 c 0 | 03 d 0 | 02 c 0 | 03 d 0 | 02 c 0 | 03 d 0 | 03 d 0
02 c 0 | 02 d 0 | 02 c 0 | 03 d 0 | 02 c 0 | 02 c 0 | 03 d 0 | 02 c 0 | 03 d 0 | 02 c 0 | 02 c 0 | 03 d 0 | 02 c 0 | 03 d 0 | 02 c 0 | 03 d 0 | 02 c 0 | 05 c 0 | 02 c 0 | 03 d 0 | 02 c 0 | 03 d 0 | 02 c 0 | 03 d 0 | 03 d 0
02 c 0 | 02 d 0 | 02 c 0 | 03 d 0 | 02 c 0 | 02 c 0 | 03 d 0 | 02 c 0 | 03 d 0 | 02 c 0 | 02 c 0 | 03 d 0 | 02 c 0 | 03 d 0 | 02 c 0 | 03 d 0 | 02 c 0 | 05 c 0 | 02 c 0 | 03 d 0 | 02 c 0 | 03 d 0 | 02 c 0 | 03 d 0 | 03 d 0
02 c 0 | 02 d 0 | 02 c 0 | 03 d 0 | 02 c 0 | 02 c 0 | 03 d 0 | 02 c 0 | 03 d 0 | 02 c 0 | 02 c 0 | 03 d 0 | 02 c 0 | 03 d 0 | 02 c 0 | 03 d 0 | 02 c 0 | 05 c 0 | 02 c 0 | 03 d 0 | 02 c 0 | 03 d 0 | 02 c 0 | 03 d 0 | 03 d 0
02 c 0 | 02 d 0 | 02 c 0 | 03 d 0 | 02 c 0 | 02 c 0 | 03 d 0 | 02 c 0 | 03 d 0 | 02 c 0 | 02 c 0 | 03 d 0 | 02 c 0 | 03 d 0 | 02 c 0 | 03 d 0 | 02 c 0 | 05 c 0 | 02 c 0 | 03 d 0 | 02 c 0 | 03 d 0 | 02 c 0 | 03 d 0 | 03 d 0
02 c 0 | 03 d 0 | 02 c 0 | 03 d 0 | 02 c 0 | 02 c 0 | 03 d 0 | 02 c 0 | 03 d 0 | 02 c 0 | 02 c 0 | 03 d 0 | 02 c 0 | 03 d 0 | 02 c 0 | 03 d 0 | 02 c 0 | 05 c 0 | 02 c 0 | 03 d 0 | 02 c 0 | 03 d 0 | 02 c 0 | 03 d 0 | 03 d 0
02 c 0 | 03 d 0 | 02 c 0 | 03 d 0 | 02 c 0 | 02 c 0 | 03 d 0 | 02 c 0 | 03 d 0 | 02 c 0 | 02 c 0 | 03 d 0 | 02 c 0 | 03 d 0 | 02 c 0 | 03 d 0 | 02 c 0 | 05 c 0 | 02 c 0 | 03 d 0 | 02 c 0 | 03 d 0 | 02 c 0 | 03 d 0 | 03 d 0
02 c 0 | 03 d 0 | 02 c 0 | 03 d 0 | 02 c 0 | 02 c 0 | 03 d 0 | 02 c 0 | 03 d 0 | 02 c 0 | 02 c 0 | 03 d 0 | 02 c 0 | 03 d 0 | 02 c 0 | 03 d 0 | 02 c 0 | 05 c 0 | 02 c 0 | 03 d 0 | 02 c 0 | 03 d 0 | 02 c 0 | 03 d 0 | 03 d 0
02 c 0 | 03 d 0 | 02 c 0 | 03 d 0 | 02 c 0 | 02 c 0 | 03 d 0 | 02 c 0 | 03 d 0 | 02 c 0 | 02 c 0 | 03 d 0 | 02 c 0 | 03 d 0 | 02 c 0 | 03 d 0 | 02 c 0 | 05 c 0 | 02 c 0 | 03 d 0 | 02 c 0 | 03 d 0 | 02 c 0 | 03 d 0 | 03 d 0
02 c 0 | 03 d 0 | 02 c 0 | 03 d 0 | 02 c 0 | 02 c 0 | 03 d 0 | 02 c 0 | 03 d 0 | 02 c 0 | 02 c 0 | 03 d 0 | 02 c 0 | 03 d 0 | 02 c 0 | 03 d 0 | 02 c 0 | 05 c 0 | 02 c 0 | 03 d 0 | 02 c 0 | 03 d 0 | 02 c 0 | 03 d 0 | 03 d 0
02 c 0 | 03 d 0 | 02 c 0 | 03 d 0 | 02 c 0 | 02 c 0 | 03 d 0 | 02 c 0 | 03 d 0 | 02 c 0 | 01 c 0 | 01 c 0 | 02 c 0 | 02 d 0 | 02 e 0 | 10 a 1 | 10 a 2 | 05 c 0 | 02 d 0 | 02 e 0 | 02 e 0 | 02 e 0 | 02 e 0 | 02 f 0 | 02 f 0
02 c 0 | 03 d 0 | 02 c 0 | 03 d 0 | 02 c 0 | 02 c 0 | 03 d 0 | 02 c 0 | 03 d 0 | 02 c 0 | 01 c 0 | 01 c 0 | 02 c 0 | 03 d 0 | 03 d 0 | 10 a 3 | 10 a 4 | 05 c 0 | 03 d 0 | 03 d 0 | 02 e 0 | 02 e 0 | 02 e 0 | 02 f 0 | 02 f 0
02 c 0 | 03 d 0 | 02 c 0 | 03 d 0 | 02 c 0 | 02 c 0 | 03 d 0 | 02 c 0 | 03 d 0 | 02 c 0 | 02 d 0 | 02 d 0 | 02 c 0 | 02 c 0 | 03 d 0 | 02 d 0 | 02 d 0 | 05 c 0 | 02 c 0 | 03 d 0 | 02 e 0 | 02 e 0 | 02 e 0 | 02 f 0 | 03 f 0
02 c 0 | 03 d 0 | 02 c 0 | 03 d 0 | 02 c 0 | 02 c 0 | 03 d 0 | 02 c 0 | 03 d 0 | 02 c 0 | 03 c 0 | 02 c 0 | 01 c 0 | 01 c 0 | 02 c 0 | 03 c 0 | 02 c 0 | 05 c 0 | 01 c 0 | 02 c 0 | 02 e 0 | 02 e 0 | 02 e 0 | 02 f 0 | 03 f 0
02 c 0 | 03 d 0 | 02 c 0 | 03 d 0 | 02 c 0 | 02 c 0 | 03 d 0 | 02 c 0 | 03 d 0 | 02 c 0 | 01 c 0 | 01 a 0 | 01 b 0 | 01 b 0 | 02 c 0 | 01 c 0 | 01 a 0 | 05 b 0 | 01 c 0 | 01 c 0 | 02 e 0 | 02 e 0 | 02 e 0 | 02 f 0 | 03 f 0
02 c 0 | 03 d 0 | 02 c 0 | 03 d 0 | 02 c 0 | 02 c 0 | 03 d 0 | 02 c 0 | 03 d 0 | 02 c 0 | 01 c 0 | 01 c 0 | 02 c 0 | 02 d 0 | 02 e 0 | 01 c 0 | 01 c 0 | 05 c 0 | 02 d 0 | 02 e 0 | 02 e 0 | 02 e 0 | 02 e 0 | 83 f 0 | 84 f 0
02 c 0 | 03 d 0 | 02 c 0 | 03 d 0 | 02 c 0 | 02 c 0 | 03 d 0 | 02 c 0 | 03 d 0 | 02 c 0 | 01 c 0 | 01 c 0 | 02 c 0 | 03 d 0 | 03 d 0 | 09 c 1 | 09 c 2 | 05 c 0 | 03 d 0 | 03 d 0 | 02 e 0 | 02 e 0 | 02 e 0 | 81 f 0 | 82 f 0
02 c 0 | 03 d 0 | 02 c 0 | 03 d 0 | 02 c 0 | 02 c 0 | 03 d 0 | 02 c 0 | 03 d 0 | 02 c 0 | 02 d 0 | 02 d 0 | 02 c 0 | 02 c 0 | 03 d 0 | 09 d 3 | 09 d 4 | 05 c 0 | 02 c 0 | 03 d 0 | 02 e 0 | 02 e 0 | 02 f 0 | 81 f 0 | 80 f 0
02 c 0 | 03 d 0 | 02 c 0 | 03 d 0 | 02 c 0 | 02 c 0 | 03 d 0 | 02 c 0 | 03 d 0 | 02 c 0 | 03 c 0 | 02 c 0 | 01 c 0 | 01 c 0 | 09 c 1 | 09 c 2 | 02 c 0 | 05 c 0 | 01 c 0 | 02 c 0 | 02 e 0 | 03 e 0 | 99 f 1 | 99 f 2 | 99 f 3
02 c 0 | 03 d 0 | 02 c 0 | 03 d 0 | 02 c 0 | 02 c 0 | 03 d 0 | 02 c 0 | 03 d 0 | 02 c 0 | 01 c 0 | 01 a 0 | 01 b 0 | 01 c 0 | 09 c 3 | 09 c 4 | 01 a 0 | 05 b 0 | 01 c 0 | 02 c 0 | 02 e 0 | 03 e 0 | 99 f 4 | 99 f 5 | 99 f 6
02 c 0 | 03 d 0 | 02 c 0 | 03 d 0 | 02 c 0 | 02 c 0 | 03 d 0 | 02 c 0 | 03 d 0 | 02 c 0 | 01 c 0 | 01 c 0 | 02 c 0 | 03 d 0 | 03 d 0 | 01 c 0 | 01 c 0 | 05 c 0 | 03 d 0 | 03 d 0 | 02 e 0 | 03 e 0 | 99 f 7 | 99 f 8 | 99 f 9
02 c 0 | 03 d 0 | 02 c 0 | 03 d 0 | 02 c 0 | 02 c 0 | 03 d 0 | 02 c 0 | 03 d 0 | 02 c 0 | 01 c 0 | 01 c 0 | 02 c 0 | 03 d 0 | 03 d 0 | 01 c 0 | 01 c 0 | 05 c 0 | 03 d 0 | 03 d 0 | 02 e 0 | 02 e 0 | 02 f 0 | 81 f 0 | 80 f 0
02 c 0 | 03 d 0 | 02 c 0 | 03 d 0 | 02 c 0 | 02 c 0 | 03 d 0 | 02 c 0 | 03 d 0 | 02 c 0 | 01 c 0 | 01 c 0 | 02 c 0 | 03 d 0 | 03 d 0 | 01 c 0 | 01 c 0 | 05 c 0 | 03 d 0 | 03 d 0 | 02 e 0 | 02 e 0 | 02 f 0 | 81 f 0 | 80 f 0
02 c 0 | 03 d 0 | 02 c 0 | 03 d 0 | 02 c 0 | 02 c 0 | 03 d 0 | 02 c 0 | 03 d 0 | 02 c 0 | 01 c 0 | 01 c 0 | 02 c 0 | 03 d 0 | 03 d 0 | 01 c 0 | 01 c 0 | 05 c 0 | 03 d 0 | 02 e 0 | 02 e 0 | 02 e 0 | 03 f 0 | 81 f 0 | 80 f 0
02 c 0 | 03 d 0 | 02 c 0 | 03 d 0 | 02 c 0 | 02 c 0 | 03 d 0 | 02 c 0 | 03 d 0 | 02 c 0 | 01 c 0 | 01 c 0 | 02 c 0 | 03 d 0 | 03 d 0 | 01 c 0 | 01 c 0 | 05 c 0 | 03 d 0 | 02 e 0 | 02 e 0 | 02 e 0 | 03 f 0 | 81 f 0 | 80 f 0